8 8 8 8 8 8 8 8 8 8 9 8 8 8 8 8 8 8 8 8 8 8 8 8 8 8 8 8 8 8 8 8 8 8 8 8 8 8 8 8 8 8 8 8 8 8 8 8 8 8
8 8 8 9 8 8 8 8 8 8 9 8 9 8 8 8 8 8 8 8 8 8 8 8 8 8 8 8 8 8 8 8 8 8 8 8 8 8 8 8 8 8 8 8 8 8 8 8 8 8
9 8 8 8 9 8 8 8 8 9 8 8 8 9 8 8 8 8 8 8 8 8 8 8 8 8 8 8 8 8 8 8 8 8 8 8 8 8 8 8 8 8 8 8 8 8 8 8 8 8
8 8 8 8 8 8 8 2 3 2 3 2 8 8 8 8 8 9 8 8 8 8 8 8 8 8 8 9 8 8 8 8 8 8 8 8 8 8 8 9 9 8 8 8 8 8 8 8 8 8
9 8 8 8 8 8 8 3 5 5 5 3 8 8 8 8 8 8 8 8 8 8 8 8 8 8 8 8 8 8 8 8 8 8 8 9 8 8 8 8 8 8 8 8 8 8 8 8 8 8
8 8 9 8 8 8 8 3 5 5 5 2 8 8 8 8 8 8 9 8 8 8 8 8 9 8 8 2 3 2 3 2 8 8 8 8 8 8 8 8 9 8 8 8 9 8 8 8 8 8
8 9 8 8 8 8 8 3 3 5 3 2 8 8 9 8 8 8 8 8 8 8 8 8 8 8 8 3 5 5 5 3 8 8 8 8 9 8 8 8 8 8 9 8 8 8 8 8 8 8
8 8 9 8 8 8 8 7 7 7 7 9 8 8 8 8 8 8 8 8 8 8 8 8 8 8 8 3 5 5 5 2 8 8 8 8 8 8 8 8 8 8 8 8 8 8 8 8 8 8
8 8 8 8 8 8 8 8 7 7 7 7 7 7 7 7 7 7 7 7 7 7 7 7 7 7 7 3 3 5 3 2 8 8 8 8 8 8 8 8 8 8 8 8 8 9 8 8 8 8
8 8 8 8 8 8 7 7 7 7 7 7 7 7 7 7 7 7 7 7 7 7 7 7 7 7 7 7 7 7 7 7 7 8 8 8 9 8 8 8 8 8 8 8 8 8 8 8 8 8
8 8 8 8 8 7 7 7 7 7 8 8 8 8 8 8 8 8 8 8 7 8 8 8 8 8 8 7 7 7 7 7 7 8 8 8 8 8 8 9 8 8 8 8 8 8 8 8 8 8
8 8 8 8 8 7 7 7 7 7 8 8 8 8 9 8 8 8 8 8 8 8 8 8 8 8 8 8 8 8 8 8 8 8 8 8 8 8 8 8 8 9 8 8 8 9 8 8 8 8
8 8 8 7 7 7 7 7 8 8 9 8 8 8 8 8 8 8 8 8 8 8 8 8 8 8 8 8 8 8 8 8 8 8 8 8 8 8 8 8 8 8 8 8 8 8 8 8 8 8
8 7 7 7 7 7 7 8 8 8 9 9 8 8 8 8 8 8 9 8 8 8 8 8 8 8 8 8 8 9 8 8 8 8 8 8 8 8 8 8 8 8 8 9 8 8 8 9 8 8
9 7 7 8 9 8 8 8 8 9 8 8 8 9 8 8 8 8 8 8 9 8 8 8 8 8 8 8 8 8 8 8 8 8 8 8 8 8 8 8 8 8 8 8 8 8 8 8 8 8
8 8 7 7 8 8 8 8 8 8 8 8 8 8 9 8 8 8 8 8 8 8 8 8 8 8 8 8 8 8 8 8 8 9 8 8 9 8 8 8 8 8 8 8 8 7 7 7 9 8
9 8 8 7 7 8 8 8 8 8 8 8 8 8 8 8 8 8 8 8 9 8 8 8 8 8 8 8 8 8 8 8 8 8 8 8 8 8 8 8 8 8 8 8 8 7 7 7 8 8
8 8 9 8 7 7 8 8 8 8 8 8 8 8 8 8 9 8 8 8 8 8 8 8 9 8 8 8 8 8 8 8 8 8 8 8 8 8 9 8 8 8 8 8 8 7 7 7 8 8
8 9 8 8 8 7 7 7 7 7 8 8 9 8 9 8 8 8 8 8 8 8 9 8 8 8 8 8 8 8 8 8 8 8 8 8 8 8 8 8 9 8 8 8 8 7 7 7 9 8
8 8 9 8 8 8 7 7 7 7 7 9 8 8 8 8 8 8 8 8 8 8 8 8 8 8 8 9 8 8 9 8 8 8 8 8 8 8 8 8 8 8 8 8 8 8 7 8 8 8
8 8 8 8 8 8 8 8 7 7 7 7 8 8 8 9 8 8 8 8 8 8 8 8 8 8 8 8 8 8 8 8 8 8 9 8 8 9 8 8 8 9 8 9 8 8 7 8 8 8
8 8 8 8 8 8 8 8 7 7 7 8 8 8 8 8 8 8 8 8 8 9 7 7 7 7 7 7 7 8 8 8 8 8 8 8 8 8 8 8 8 8 8 8 8 8 7 8 8 8 
8 8 8 8 8 8 8 8 7 7 7 8 8 8 8 8 8 8 8 8 8 7 7 7 7 7 7 7 7 7 8 9 8 8 8 8 8 8 8 9 8 8 8 8 8 8 7 8 9 8
8 8 8 7 7 7 7 7 7 7 7 7 7 7 7 7 7 7 7 7 7 7 7 7 7 7 7 7 7 7 8 8 8 8 9 8 8 8 8 8 8 8 9 8 8 8 7 8 8 8
8 8 7 7 7 7 7 7 7 7 7 7 7 7 7 7 7 7 7 7 7 7 7 7 7 7 7 7 7 7 8 8 8 8 9 8 8 8 8 8 8 8 8 8 9 8 7 8 8 8
8 8 7 7 7 7 7 7 7 7 7 7 7 7 7 7 7 7 7 7 7 7 7 7 7 7 7 7 7 7 8 8 8 8 8 8 8 8 8 8 8 8 8 8 8 8 7 8 8 8
8 8 7 7 7 7 7 8 8 8 8 8 8 8 7 8 8 8 8 7 8 8 7 7 7 7 7 7 7 8 8 8 8 8 8 9 8 8 9 8 8 8 8 8 8 8 7 8 8 8
8 8 7 7 7 7 8 8 9 8 8 8 8 8 8 9 8 8 9 8 8 8 8 8 7 7 7 8 8 8 8 8 8 8 8 8 8 8 8 8 8 8 8 9 8 7 7 8 8 8
8 8 8 7 7 7 8 8 8 8 9 8 8 9 8 8 8 8 8 8 8 8 8 8 7 7 7 8 8 8 8 9 8 8 9 8 8 9 8 8 8 8 8 8 7 7 8 8 9 8
8 8 9 8 7 7 7 8 8 8 8 8 8 8 8 9 8 8 8 8 9 8 8 8 7 7 7 8 8 8 8 8 8 8 8 8 8 8 8 8 8 8 8 7 7 8 8 8 8 8
8 9 8 8 8 7 7 7 7 7 8 8 8 8 9 8 8 8 8 8 8 8 8 8 7 7 7 7 8 8 8 8 8 8 8 8 8 8 8 8 8 8 7 7 8 8 8 9 8 8
8 8 9 8 8 8 7 7 7 7 7 9 8 8 8 8 8 9 8 8 8 8 9 8 7 7 7 8 9 8 8 9 8 9 8 8 8 8 8 8 8 7 7 8 8 8 8 8 8 8
8 8 8 9 8 8 8 8 7 7 7 7 7 7 7 7 8 8 8 8 8 8 8 8 7 7 7 8 8 8 8 8 8 8 8 8 8 8 8 8 8 7 7 8 8 8 8 8 8 8
8 8 9 8 8 8 9 8 4 6 4 7 7 7 7 7 8 8 8 8 8 9 8 8 7 7 7 8 8 8 9 8 8 8 9 8 8 8 8 8 8 7 7 8 8 8 8 9 8 8
8 8 8 8 9 8 8 8 8 6 4 4 6 7 7 7 8 8 8 8 8 8 8 8 7 7 7 8 8 9 8 8 8 8 8 8 8 8 8 8 7 7 8 8 8 9 8 8 8 8
8 8 8 8 8 9 8 8 8 9 8 8 8 7 7 7 8 8 9 8 8 9 8 7 7 7 7 7 8 8 8 9 9 8 8 8 8 9 8 8 7 7 8 8 8 8 8 8 8 8
8 8 8 8 8 8 8 8 8 8 9 8 8 8 8 8 8 8 8 8 8 8 8 7 7 7 7 7 7 7 8 8 8 8 8 8 8 8 8 8 8 7 7 8 8 9 8 8 8 8
8 8 8 9 8 8 8 9 8 8 9 8 8 8 8 8 8 8 8 8 8 7 7 7 7 7 7 7 7 7 7 8 8 8 8 8 8 8 8 8 8 7 7 8 8 8 8 9 8 8
8 8 8 8 9 8 2 3 2 3 2 2 3 9 8 8 8 8 8 8 7 7 7 7 7 8 8 7 7 7 7 7 8 8 8 8 8 8 8 8 8 7 7 8 8 8 9 8 8 8
8 8 8 8 8 8 3 5 5 5 5 5 2 8 8 8 8 8 8 8 7 7 7 7 8 8 9 8 7 7 7 7 7 8 8 8 8 8 8 8 8 7 7 8 8 8 8 8 8 8
8 8 8 8 8 8 3 5 5 5 5 5 2 8 8 8 8 8 7 7 7 7 7 8 8 8 8 8 8 7 7 7 7 7 7 7 7 7 7 7 7 7 7 7 8 8 8 8 8 8
8 8 9 8 8 8 3 3 2 5 2 2 3 8 8 8 7 7 7 7 7 8 8 9 8 9 8 8 8 8 7 7 7 7 7 7 7 7 7 7 7 7 7 7 7 8 8 8 8 8
8 9 8 8 8 8 7 7 7 7 7 7 7 7 7 7 7 7 7 8 8 8 8 8 8 8 8 8 8 8 8 7 7 8 8 8 8 8 8 7 7 7 7 7 7 7 8 8 8 8
8 8 9 8 8 8 7 7 7 7 7 7 7 7 7 7 7 7 8 8 8 8 8 9 8 8 9 8 8 8 7 7 8 8 8 8 8 8 7 7 7 7 7 7 7 7 7 8 8 8
8 8 8 8 8 8 8 8 7 7 7 7 7 7 7 7 8 8 9 8 8 8 8 8 8 4 4 4 4 7 7 8 8 8 8 8 8 7 7 7 7 7 7 7 7 7 7 9 8 8
8 8 9 8 8 8 9 8 4 6 4 7 7 7 7 8 8 8 8 8 8 9 8 4 4 4 4 4 4 7 7 8 8 8 8 8 9 8 9 8 8 8 8 8 8 8 8 8 8 8
8 8 8 8 9 8 8 8 8 6 4 4 6 4 4 8 8 8 8 8 8 8 8 6 4 6 6 4 4 6 7 7 9 8 8 8 8 8 8 8 8 8 8 9 8 8 8 8 8 8
8 8 8 8 8 8 8 8 8 9 4 4 6 4 6 8 9 8 8 9 8 8 8 8 4 4 4 4 4 7 7 8 8 8 9 8 8 8 8 8 8 8 8 8 8 8 9 8 8 8
8 8 8 8 9 8 8 8 8 6 4 6 6 4 9 8 8 8 8 8 8 9 8 8 8 6 6 4 7 7 8 8 8 8 8 8 8 8 9 8 8 8 8 9 8 8 8 8 8 8
8 8 8 8 8 8 8 8 8 9 4 4 6 8 8 8 8 8 9 8 8 8 8 8 9 8 8 8 9 8 8 8 9 8 8 8 8 8 8 8 9 8 8 8 8 8 8 8 9 8